[john@FedoraDev first_app]$ man ifconfig
[john@FedoraDev first_app]$ man ip link
--Man-- next: link(1) [ view (return) | skip (Ctrl-D) | quit (Ctrl-C) ]
q 
[john@FedoraDev first_app]$ 
[john@FedoraDev first_app]$ ifconfig
em1       Link encap:Ethernet  HWaddr 00:21:97:6B:EA:65  
          inet addr:192.168.10.192  Bcast:192.168.10.255  Mask:255.255.255.0
          inet6 addr: fe80::221:97ff:fe6b:ea65/64 Scope:Link
          UP BROADCAST RUNNING MULTICAST  MTU:1500  Metric:1
          RX packets:854001 errors:0 dropped:0 overruns:0 frame:0
          TX packets:509010 errors:0 dropped:0 overruns:0 carrier:0
          collisions:0 txqueuelen:1000 
          RX bytes:281627080 (268.5 MiB)  TX bytes:103563175 (98.7 MiB)
          Interrupt:43 Base address:0xa000 

lo        Link encap:Local Loopback  
          inet addr:127.0.0.1  Mask:255.0.0.0
          inet6 addr: ::1/128 Scope:Host
          UP LOOPBACK RUNNING  MTU:16436  Metric:1
          RX packets:300 errors:0 dropped:0 overruns:0 frame:0
          TX packets:300 errors:0 dropped:0 overruns:0 carrier:0
          collisions:0 txqueuelen:0 
          RX bytes:21398 (20.8 KiB)  TX bytes:21398 (20.8 KiB)

[john@FedoraDev first_app]$ /sbin/service sshd statis
Redirecting to /bin/systemctl  statis sshd.service
Unknown operation statis
[john@FedoraDev first_app]$ /sbin/service sshd status
Redirecting to /bin/systemctl  status sshd.service
sshd.service - OpenSSH server daemon
	  Loaded: loaded (/lib/systemd/system/sshd.service; enabled)
	  Active: active (running) since Mon, 16 Jan 2012 18:51:21 -0800; 5 days ago
	Main PID: 1006 (sshd)
	  CGroup: name=systemd:/system/sshd.service
		  └ 1006 /usr/sbin/sshd -D
[john@FedoraDev first_app]$ Hey I think Putty is running as of this point
bash: Hey: command not found...
[john@FedoraDev first_app]$ pwd
/home/john/rails_projects/first_app
[john@FedoraDev first_app]$ cd ..
[john@FedoraDev rails_projects]$ pwd
/home/john/rails_projects
[john@FedoraDev rails_projects]$ rails new demo_app
       exist  
   identical  README
   identical  Rakefile
   identical  config.ru
   identical  .gitignore
   identical  Gemfile
       exist  app
   identical  app/controllers/application_controller.rb
   identical  app/helpers/application_helper.rb
       exist  app/mailers
       exist  app/models
   identical  app/views/layouts/application.html.erb
       exist  config
   identical  config/routes.rb
   identical  config/application.rb
   identical  config/environment.rb
       exist  config/environments
   identical  config/environments/development.rb
   identical  config/environments/production.rb
   identical  config/environments/test.rb
       exist  config/initializers
   identical  config/initializers/backtrace_silencers.rb
   identical  config/initializers/inflections.rb
   identical  config/initializers/mime_types.rb
    conflict  config/initializers/secret_token.rb
Overwrite /home/john/rails_projects/demo_app/config/initializers/secret_token.rb? (enter "h" for help) [Ynaqdh] n
        skip  config/initializers/secret_token.rb
   identical  config/initializers/session_store.rb
       exist  config/locales
   identical  config/locales/en.yml
   identical  config/boot.rb
   identical  config/database.yml
       exist  db
   identical  db/seeds.rb
       exist  doc
   identical  doc/README_FOR_APP
       exist  lib
       exist  lib/tasks
   identical  lib/tasks/.gitkeep
       exist  log
   identical  log/server.log
   identical  log/production.log
   identical  log/development.log
   identical  log/test.log
       exist  public
   identical  public/404.html
   identical  public/422.html
   identical  public/500.html
   identical  public/favicon.ico
   identical  public/index.html
   identical  public/robots.txt
       exist  public/images
   identical  public/images/rails.png
       exist  public/stylesheets
   identical  public/stylesheets/.gitkeep
       exist  public/javascripts
   identical  public/javascripts/application.js
   identical  public/javascripts/controls.js
   identical  public/javascripts/dragdrop.js
   identical  public/javascripts/effects.js
   identical  public/javascripts/prototype.js
   identical  public/javascripts/rails.js
       exist  script
   identical  script/rails
       exist  test
       exist  test/fixtures
       exist  test/functional
       exist  test/integration
   identical  test/performance/browsing_test.rb
   identical  test/test_helper.rb
       exist  test/unit
       exist  tmp
       exist  tmp/sessions
       exist  tmp/sockets
       exist  tmp/cache
       exist  tmp/pids
       exist  vendor/plugins
   identical  vendor/plugins/.gitkeep
[john@FedoraDev rails_projects]$ cd demo_app
[john@FedoraDev demo_app]$ ls -la
total 80
drwxrwxr-x. 13 john john 4096 Jan 22 17:35 .
drwxrwxr-x.  4 john john 4096 Jan 22 17:35 ..
drwxrwxr-x.  7 john john 4096 Jan 22 17:35 app
drwxrwxr-x.  5 john john 4096 Jan 22 17:35 config
-rw-rw-r--.  1 john john  157 Jan 22 17:35 config.ru
drwxrwxr-x.  2 john john 4096 Jan 22 17:35 db
drwxrwxr-x.  2 john john 4096 Jan 22 17:35 doc
-rw-rw-r--.  1 john john  665 Jan 22 17:35 Gemfile
-rw-rw-r--.  1 john john   40 Jan 22 17:35 .gitignore
drwxrwxr-x.  3 john john 4096 Jan 22 17:35 lib
drwxrwxr-x.  2 john john 4096 Jan 22 17:35 log
drwxrwxr-x.  5 john john 4096 Jan 22 17:35 public
-rw-rw-r--.  1 john john  267 Jan 22 17:35 Rakefile
-rw-rw-r--.  1 john john 9130 Jan 22 17:35 README
drwxr-xr-x.  2 john john 4096 Jan 22 17:35 script
drwxrwxr-x.  7 john john 4096 Jan 22 17:35 test
drwxrwxr-x.  6 john john 4096 Jan 22 17:35 tmp
drwxrwxr-x.  3 john john 4096 Jan 22 17:35 vendor
[john@FedoraDev demo_app]$ gedit Gemfile
[john@FedoraDev demo_app]$ cd ..
[john@FedoraDev rails_projects]$ cd firs*
[john@FedoraDev first_app]$ gedit Gemfile
[john@FedoraDev first_app]$ cd ..
[john@FedoraDev rails_projects]$ cd dem*
[john@FedoraDev demo_app]$ gedit Gemfile

** (gedit:30188): CRITICAL **: gedit_spell_checker_language_to_key: assertion `lang != NULL' failed
[john@FedoraDev demo_app]$ bundle install
Fetching source index for http://rubygems.org/
Using rake (0.9.2.2) 
Using abstract (1.0.0) 
Using activesupport (3.0.1) 
Using builder (2.1.2) 
Using i18n (0.4.2) 
Using activemodel (3.0.1) 
Using erubis (2.6.6) 
Using rack (1.2.5) 
Using rack-mount (0.6.14) 
Using rack-test (0.5.7) 
Using tzinfo (0.3.31) 
Using actionpack (3.0.1) 
Using mime-types (1.17.2) 
Using polyglot (0.3.3) 
Using treetop (1.4.10) 
Using mail (2.2.19) 
Using actionmailer (3.0.1) 
Using arel (1.0.1) 
Using activerecord (3.0.1) 
Using activeresource (3.0.1) 
Using bundler (1.0.21) 
Using thor (0.14.6) 
Using railties (3.0.1) 
Using rails (3.0.1) 
Using sqlite3-ruby (1.2.5) 
Your bundle is complete! Use `bundle show [gemname]` to see where a bundled gem is installed.
[john@FedoraDev demo_app]$ bundle show demo_app
Could not find gem 'demo_app' in the current bundle.
[john@FedoraDev demo_app]$ cd ..
[john@FedoraDev rails_projects]$ cd fir*
[john@FedoraDev first_app]$ gedit Gemfile
[john@FedoraDev first_app]$ gedit .gitignore
[john@FedoraDev first_app]$ cd ../demo_app
[john@FedoraDev demo_app]$ gedit .gitignore

** (gedit:30238): CRITICAL **: gedit_spell_checker_language_to_key: assertion `lang != NULL' failed
[john@FedoraDev demo_app]$ git init
Initialized empty Git repository in /home/john/rails_projects/demo_app/.git/
[john@FedoraDev demo_app]$ git add .
[john@FedoraDev demo_app]$ git commit -m "Initial commit"
[master (root-commit) 930c6a9] Initial commit
 42 files changed, 10326 insertions(+), 0 deletions(-)
 create mode 100644 .gitignore
 create mode 100644 .gitignore~
 create mode 100644 Gemfile
 create mode 100644 Gemfile.lock
 create mode 100644 Gemfile~
 create mode 100644 README
 create mode 100644 Rakefile
 create mode 100644 app/controllers/application_controller.rb
 create mode 100644 app/helpers/application_helper.rb
 create mode 100644 app/views/layouts/application.html.erb
 create mode 100644 config.ru
 create mode 100644 config/application.rb
 create mode 100644 config/boot.rb
 create mode 100644 config/database.yml
 create mode 100644 config/environment.rb
 create mode 100644 config/environments/development.rb
 create mode 100644 config/environments/production.rb
 create mode 100644 config/environments/test.rb
 create mode 100644 config/initializers/backtrace_silencers.rb
 create mode 100644 config/initializers/inflections.rb
 create mode 100644 config/initializers/mime_types.rb
 create mode 100644 config/initializers/secret_token.rb
 create mode 100644 config/initializers/session_store.rb
 create mode 100644 config/locales/en.yml
 create mode 100644 config/routes.rb
 create mode 100644 db/seeds.rb
 create mode 100644 doc/README_FOR_APP
 create mode 100644 lib/tasks/.gitkeep
 create mode 100644 public/404.html
 create mode 100644 public/422.html
 create mode 100644 public/500.html
 create mode 100644 public/favicon.ico
 create mode 100644 public/images/rails.png
 create mode 100644 public/index.html
 create mode 100644 public/javascripts/application.js
 create mode 100644 public/javascripts/controls.js
 create mode 100644 public/javascripts/dragdrop.js
 create mode 100644 public/javascripts/effects.js
 create mode 100644 public/javascripts/prototype.js
 create mode 100644 public/javascripts/rails.js
 create mode 100644 public/robots.txt
 create mode 100644 public/stylesheets/.gitkeep
 create mode 100755 script/rails
 create mode 100644 test/performance/browsing_test.rb
 create mode 100644 test/test_helper.rb
 create mode 100644 vendor/plugins/.gitkeep
[john@FedoraDev demo_app]$ git remote add origin git@github.com:jbgoode/demo_app.git
[john@FedoraDev demo_app]$ git push origin master
ERROR: jbgoode/demo_app.git doesn't exist. Did you enter it correctly?
fatal: The remote end hung up unexpectedly
[john@FedoraDev demo_app]$ git remote add origin git@github.com:jbgoode/demo_app.git
fatal: remote origin already exists.
[john@FedoraDev demo_app]$ git push origin masterCounting objects: 65, done.
Delta compression using up to 2 threads.
Compressing objects: 100% (50/50), done.
Writing objects: 100% (65/65), 86.53 KiB, done.
Total 65 (delta 2), reused 0 (delta 0)
To git@github.com:jbgoode/demo_app.git
 * [new branch]      master -> master
[john@FedoraDev demo_app]$ rails generate scaffold User name:string email:string
      invoke  active_record
      create    db/migrate/20120129010725_create_users.rb
      create    app/models/user.rb
      invoke    test_unit
      create      test/unit/user_test.rb
      create      test/fixtures/users.yml
       route  resources :users
      invoke  scaffold_controller
      create    app/controllers/users_controller.rb
      invoke    erb
      create      app/views/users
      create      app/views/users/index.html.erb
      create      app/views/users/edit.html.erb
      create      app/views/users/show.html.erb
      create      app/views/users/new.html.erb
      create      app/views/users/_form.html.erb
      invoke    test_unit
      create      test/functional/users_controller_test.rb
      invoke    helper
      create      app/helpers/users_helper.rb
      invoke      test_unit
      create        test/unit/helpers/users_helper_test.rb
      invoke  stylesheets
      create    public/stylesheets/scaffold.css
[john@FedoraDev demo_app]$ rake db:migrate
WARNING: 'require 'rake/rdoctask'' is deprecated.  Please use 'require 'rdoc/task' (in RDoc 2.4.2+)' instead.
    at /home/john/.rvm/gems/ruby-1.9.2-p290/gems/rake-0.9.2.2/lib/rake/rdoctask.rb
WARNING: Global access to Rake DSL methods is deprecated.  Please include
    ...  Rake::DSL into classes and modules which use the Rake DSL methods.
WARNING: DSL method DemoApp::Application#task called at /home/john/.rvm/gems/ruby-1.9.2-p290/gems/railties-3.0.1/lib/rails/application.rb:214:in `initialize_tasks'
==  CreateUsers: migrating ====================================================
-- create_table(:users)
   -> 0.0016s
==  CreateUsers: migrated (0.0019s) ===========================================

[john@FedoraDev demo_app]$ 

